#########
#..####.#
#...##..#
#....@..#
##....###
#####..##
#.......#
#.#######
#########